wwwwwwwwwwwwwwwwwwwww
w                   w
w m          E      w
w                 E w
w                   w
w         T         w
w                   w
w  E                w
w                   w
w                   w
wwwwwwwwwwwwwwwwwwwww