wwwwwwwwwwwwwwwwwwwww
w         T         w
w                   w
w                   w
w                   w
wT                T w
w                 E w
w                   w
w                   w
w          T        w
wwwwwwwwwwwwwwwwwwwww